##########
# B      #
#      D #
#        #
#        #
#        #
#        #
# A      #
#      C #
##########