##########
#        #
#        #
#        #
#   DC   #
#    BA  #
#        #
#        #
#        #
##########