##########
#AB      #
#        #
#        #
#        #
#        #
#        #
#       D#
#       C#
##########