##########
#        #
#   C    #
#        #
#   A    #
#        #
#   B    #
#        #
#   D    #
##########