##########
#A      B#
#        #
#        #
#        #
#        #
#        #
#        #
#C      D#
##########