##########
#        #
#   C    #
#        #
#   B    #
#        #
#     D  #
# A      #
#        #
##########