##########
#        #
#        #
#  B  A  #
#        #
#  C  D  #
#        #
#        #
#        #
##########