##########
#        #
#        #
#    B   #
#   A C  #
#    D   #
#        #
#        #
#        #
##########