##########
#       D#
#      A #
#        #
#        #
#        #
#        #
# B      #
#C       #
##########