##########
#        #
#        #
#     A  #
#  B     #
#     D  #
#        #
#  C     #
#        #
##########