##########
#        #
#        #
#   D    #
#  C     #
#   B    #
#  A     #
#        #
#        #
##########