##########
#        #
#        #
#   A    #
#     D  #
#        #
#     C  #
#   B    #
#        #
##########