##########
#C      A#
#        #
#        #
#        #
#        #
#     B  #
#        #
#D       #
##########