##########
#        #
#        #
#   A    #
#   C    #
#   B    #
#   D    #
#        #
#        #
##########